{
    "1": "41",
    "2": "30",
    "3": "31",
    "4": "32",
    "5": "33",
    "6": "34",
    "7": "35",
    "8": "36",
    "9": "37",
    "10": "38",
    "11": "39",
    "12": "45",
    "13": "46",
    "14": "42",
    "15": "43",
    "16": "20",
    "17": "26",
    "18": "8",
    "19": "21",
    "20": "23",
    "21": "28",
    "22": "24",
    "23": "12",
    "24": "18",
    "25": "19",
    "26": "47",
    "27": "48",
    "28": "40",
    "29": "224",
    "30": "4",
    "31": "22",
    "32": "7",
    "33": "9",
    "34": "10",
    "35": "11",
    "36": "13",
    "37": "14",
    "38": "15",
    "39": "51",
    "40": "52",
    "41": "53",
    "42": "225",
    "43": "49",
    "44": "29",
    "45": "27",
    "46": "6",
    "47": "25",
    "48": "5",
    "49": "17",
    "50": "16",
    "51": "54",
    "52": "55",
    "53": "56",
    "54": "229",
    "55": "85",
    "56": "226",
    "57": "44",
    "58": "57",
    "59": "58",
    "60": "59",
    "61": "60",
    "62": "61",
    "63": "62",
    "64": "63",
    "65": "64",
    "66": "65",
    "67": "66",
    "68": "67",
    "69": "83",
    "70": "71",
    "71": "75",
    "72": "80",
    "73": "78",
    "74": "86",
    "75": "79",
    "76": "76",
    "77": "81",
    "78": "77",
    "79": "74",
    "80": "82",
    "81": "89",
    "82": "90",
    "83": "91",
    "84": "92",
    "85": "93",
    "86": "94",
    "87": "68",
    "88": "69",
    "89": "96",
    "90": "97",
    "91": "98",
    "92": "99",
    "93": "100",
    "94": "101",
    "95": "102",
    "96": "103",
    "97": "228",
    "98": "105",
    "99": "106",
    "100": "230",
    "101": "109",
    "102": "74",
    "103": "82",
    "104": "75",
    "105": "80",
    "106": "79",
    "107": "77",
    "108": "81",
    "109": "78",
    "110": "73",
    "111": "76"
}